Компоненты действий:
Appropriation - Перенос блоков.
Attract - Манипуляция мобами/игроками.
Вlink - Телепортация на 7 блоков.
Charm - Порабощение мобов.
Create Water - Создание блока воды.
Dig - Копание.
Disarm - Вырывание предмета из рук.
Dispel - Снятие баффов,аналог молока.
Divine Invertion - Телепортация к кровати/на спавн.
Drought - Иссушение блоков/воды.
Ender Invertion - Телепортация в ад.
Fling - Подбрасывание.
Forge - Переплавка блоков.
Grow - Ускорение роста,аналог костной муки.
Harvest plant - Сбор растений/урожая.
Heal - Лечение.
Ignition - Поджог.
Knockback - Отталкивание.
Life Drain - Выкачивание жизни.
Life Tap - Передача жизни.
Light - Фонарь/свечение.
Mana Drain - Выкачивание манны.
Mark - Марка/точка для Recall.
Place Block - Поставить выделенный блок из инвентаря.
Plant - Посадка растений.
Plow - Вскапывание.
Random Teleport - Телепортация в рандомную точку в радиусе 5 блоков.
Recall - Телепортация на Mark.
Repel - Отражение стрел и т.п.
Rift Storage - Сундук.
Summon - Призыв моба.
Telekinesis - Телекинез, манипуляция дропом.
TransPlace - Обмен местами с мобом/игроком.
Withard`s Autumn - Срывание листвы.
Damage - Урон.



Компоненты урона:
Fire Damage - Урон огнём.
Magic Damage - Урон магией.
Frost Damage - Урон холодом.
Force Damage - Физический урон.
Lighting Damage - Урон молнией.
Drown - Урон водой.